{
  "id": "map01",
  "width": 30,
  "height": 20,
  "legend": { "W": "WALL", "F": "FLOOR", "T": "TRAP", "N": "WINDOW" },
  "rows": [
    "WWWWWWWWWWWWWWWWWWWWWWWWWWWWWW",
    "WFFFFFFFFFFFFFFFFFFFFFFFFFFFFW",
    "WFFWWWWWFFFFFFFFFFFFFFWWWWWFFW",
    "WFFWFFFFFFFFFFFFFFFFFFFFFFWFFW",
    "WFFNFFFFFFFFFFFFFFFFFFFFFFNFFW",
    "WFFFFFFFFFFFFFFFFFFFFFFFFFFFFW",
    "WFFFFFFFFFFFFFFFFFFFFFFFFFFFFW",
    "WFFFFFFFFFFWWWWWWWWFFFFFFFFFFW",
    "WFFFFFFFFFFFFFFFFFFFFFFFFFFFFW",
    "WFFFFFFFFFFFFFFFFFFFFFFFFFFFFW",
    "WFFFFFFFFFFFFFTTTTFFFFFFFFFFFW",
    "WFFFFFFFFFFWWWWWWWWFFFFFFFFFFW",
    "WFFFFFFFFFFFFFFFFFFFFFFFFFFFFW",
    "WFFFFFFFFFFFFFFFFFFFFFFFFFFFFW",
    "WFFNFFFFFFFFFFFFFFFFFFFFFFNFFW",
    "WFFWFFFFFFFFFFFFFFFFFFFFFFWFFW",
    "WFFWWWWWFFFFFFFFFFFFFFWWWWWFFW",
    "WFFFFFFFFFFFFFFFFFFFFFFFFFFFFW",
    "WFFFFFFFFFFFFFFFFFFFFFFFFFFFFW",
    "WWWWWWWWWWWWWWWWWWWWWWWWWWWWWW"
  ]
}
